{"map":[
        "########################",
        "############.b######...#",
        "##...b#...#f.####....d.#",
        "##.#.##.#.##......##...#",
        "##.#.##.#....#########.#",
        "##.#.##.####.########..#",
        "##.#.##.##.....######.##",
        "##.#....##.....######.##",
        "##.#######.....####....X",
        "##......##.....######.##",
        "##.####e####.####.###.##",
        "##.#########.###..##g.g#",
        "##...............####g##",
        "########.###############",
        "#######..###...c####..a#",
        "##...##.####.##.####.###",
        "##.#.##......##........#",
        "##...#######c...######b#",
        "########################"
],
 "exit":[23, 8]
}
